 %#%%     # #%  ##  %%%# %%      %  @%%#
%   %%# %# %% % %%## #  %  %%#%%  #  %%%
  %%  %# % % %    % %  % % % %  #%%     
  %% % #% %  #     %% %    %%#%        %
%  #   @#% %%%   % #  %       %%   %% % 
#%# %   %% %%#%   %    %  %%  %     %%% 
%% %% %#   %#%# %%# %%  #  # @##%   % # 
   %  %   #  %  %  #  #%  %     #%   %% 
%      %% #  ### #% %   #%#% %  % ##    
%      # % % %  %# %%%  #%# %   %   #%% 
 % %%      #%      %    % %%   #%##  #% 
#% %   %%   #@    %%  #% %  # #    %%  %
   %   #   %%%#    %%%        %#    #%% 
% %% % #    %   % # % %% ##  %%%#      %
 %       %%%  #%  %% ##    %%% #%       
%  %      #% %# # % %    % %    %  # % %
%    %# %      % %%%  #        %  % %%%#
      %#  % #%   %# % %@ %% %#%% % %% # 
 # %#%  #  #%% %#   %       #     %# %# 
 %%@%%  % %   # %% % %# %# % #   #% # # 
